--------------------------------------------------------------------------------------------------------------------------------------------------------------------------------------------------------
--------------------------------------------------------------------------------------------------------------------------------------------------------------------------------------------------------
--------------------------------------------------------------------------------------------------------------------------------------------------------------------------------------------------------
--------------------------------------------------------------------------------------------------------------------------------------------------------------------------------------------------------
--------------------------------------------------------------------------------------------------------------------------------------------------------------------------------------------------------
--------------------------------------------------------------------------------------------------------------------------------------------------------------------------------------------------------
--------------------------------------------------------------------------------------------------------------------------------------------------------------------------------------------------------
-----------T-------------------------------------------------------------------------------------------------------------------------------------------------------------------------------------------v
-----------|-T-T------------------------------------------------------------------------------------------------?------------------T-B------------------------------------------------------T------M-T-f
---------T-|-|-|-----T---------------------------------------------------------------T-----------------------------?----T-T---T-o--|------------------?-----------T-------------------------|--------|-f
-------T-|-|-T-|----T|-T------------TT-------T---------T-----T----------------T--T-T-|-T--------T-T------T--------------|-|-T-|-|--|----TT-T-------oT-------------|--------------------T--B-|--?-T-T-|-f
----TT---|-|-|-|-T-B-|-o-T----------|-T-T----|-T-T-----|-T-T-|------T-----T-T-|----T-|-|-----------T-----T--------------|-|-|-|-|-?|-T-T-|--T-T---T-|T-T-T--T-T---|------T-T-T----T---------|o---|-|-X-f
-TTT-|---X-X-|-X--T-T-o-T-----------|-|-|-B-B|-T-------|-|-|-?------|-----T-|-|T-|-|---|-----------------|-T-T-------B--|-X-|-|-X-BX-|-|-|--|-|-T-|-||-T-|-T------|-T-------T---------------X-TT-|-|-|-f
----||-T-XX--X-X-X---------T--------X-|-|---M--------|-X-|-|-XB----X|T-T-?--|-X--X-|-T-X---------T-T-----|--------------X-X-X----------|-XX-|-|-T-|-X|-|-|-------oX-----T-?o-|-o-B---------o-TT-TX-X-|-f
m----X-------------------------T-T----X-XT---------------X-X------T-X---X-X-X------X-T------T------------X------------T--T--T----------X---XX-X-T-X--X-X-X--T-XX-X-----------X--T-T-T----------------X-X
X-X-T-XX-TX-X-X--X-X-XX---X-XX-XX-X-X-X-XX-X-X-XX-X-T-XX-X-X-X-X-X--X-XX-X-XX-XX-XX-X-X-XX-XX-X--X-X-X--X-X-XT-XT-X-X--X-XX-XX-X-X-X-X-T-X-XX-XX-X-X-TX-XX--X-X-X-XX-X-X-XX-X-X---X-T-XX-X-X-X-TX---X-XX
