--------------------------------------------------------------------------------------------------------------------------------------------------------------------------------------------------------
--------------------------------------------------------------------------------------------------------------------------------------------------------------------------------------------------------
--------------------------------------------------------------------------------------------------------------------------------------------------------------------------------------------------------
--------------------------------------------------------------------------------------------------------------------------------------------------------------------------------------------------------
--------------------------------------------------------------------------------------------------------------------------------------------------------------------------------------------------------
--------------------------------------------------------------------------------------------------------------------------------------------------------------------------------------------------------
--------------------------------------------------------------------------------------------------------------------------------------------------------------------------------------------------------
-------------------------------------------------------------------------------------------------------------------------------------------------------------------------------------------------------v
-------?--------------------------------B------------------------------------------------------------------------------------------------------------------------------------------------------------T-f
---------------------------------------------------------------------------T-------------------------------------------------------------------------------------------------------T-T---T---------T-|-f
----T-M-T----------------------Mo-TT-T-----T-------------o------M--------T-|-----T-T-T--------------------T-----------T-T-------------T---------------------------------T----------|-|-T-|-------T-|-|-f
--T-|-|-|T-T-------T----------T-T-|--|-T-T-|----------------------------Bo-|-T-?-|-|-|----------------T---|-T---T---T-|-|-T---T-T-----|-------------------------T---T-T-|-------T--|-T---|-----T-|-|-|-f
--|-|-|-|T-|----------------------|--|-|-|-|T-M-T-|-T-B--------------------|-|-T-|-|-|----------------|--M|-|-T-------|---|T--|-|----T|-|---------------------------|-|-|----------X-|---|-M-T-|-|-|-X-f
--|-X-X-X--|----------------------X--X-|-|-X------|---------------o--------X-|-T-X-X-X--------M-------|-M-X-|-?-B-T---X-X-|-T-M-|-----X-|X-T--------------?-?-------|-B-X------------X---X-----|-X-X-T-f
m-X-T-T----X--------------X------------X-X--------X----T---------------------X------------------------X-----X-T-----------X---X-X-----X-X---------------------XXX-X-X------T-T-------T---------X-------X
X-------------------------------------------------------------------------------------------------------------------------X---------------------------------------X-X----------------------------------X
