--------------------------------------------------------------------------------------------------------------------------------------------------------------------------------------------------------
--------------------------------------------------------------------------------------------------------------------------------------------------------------------------------------------------------
--------------------------------------------------------------------------------------------------------------------------------------------------------------------------------------------------------
--------------------------------------------------------------------------------------------------------------------------------------------------------------------------------------------------------
--------------------------------------------------------------------------------------------------------------------------------------------------------------------------------------------------------
--------------------------------------------------------------------------------------------------------------------------------------------------------------------------------------------------------
--------------------------------------------------------------------------------------------------------------------------------------------------------------------------------------------------------
-------------------------------------------------------------------------------------------------------------------------------------------------------------------------------------------------------v
-------?--------------------------------B----------------------------------------------------------------------------------------------------------------------------------------T-------------------T-f
---------------------------------------------------------------------------T-----------------------------------------------------------------------------------------------------|-T-T-------------T-|-f
----T-M-T----------------------M--TT-T-T---T-------------o---------------T-|-----T-T-T----T---------T-----T-------------T---T---------T------------------------?------T-T--------|-|-|------o----T-|-|-f
--T-|-|-|T-T-------T----------T-T-|--|-T-T-|----------------------------Bo-|-T-?-|-|-|---------T-----?T---|-T---T-------|-T---T-T--T--|-T---------------------------T-|-|-----T--X-|-|---------T-|-|-|-f
--|-|-|-|T-|----------------------|--|-|-|-|T-M-T-|-T-B--------------------|-|-T-|-|-|----------------|--M|-|-T---------|-|T--|----|-T|-|---------------------------|-|-|----------X-|-----T-T-|-|-|-X-f
--|-X-X-X--|----------------------X--X-|-|-X------|------------------------X-|-T-X-X-X--------------T-|-M-X-|-?-B-T-----X-|-T-|-|--|--X-|X-T------------------------|-X-X------------X-?-------B-X-X-T-f
m-X-T-T----X--------------X------------X-X--------X----T---------------------X------------------------X-----X-T-----------X---X-X--X--X-X---------------T-----------X-X----T-------------------X-------X
X-X-X-X--------------------------------X--------------------------------------------------------------X-------------------------------X-X--------------------------------------------------------------X
