--------------------------------------------------------------------------------------------------------------------------------------------------------------------------------------------------------
--------------------------------------------------------------------------------------------------------------------------------------------------------------------------------------------------------
--------------------------------------------------------------------------------------------------------------------------------------------------------------------------------------------------------
--------------------------------------------------------------------------------------------------------------------------------------------------------------------------------------------------------
--------------------------------------------------------------------------------------------------------------------------------------------------------------------------------------------------------
--------------------------------------------------------------------------------------------------------------------------------------------------------------------------------------------------------
--------------------------------------------------------------------------------------------------------------------------------------------------------------------------------------------------------
-------------------------------------------------------------------------------------------------------------------------------------------------------------------------------------------------------v
----------------------------------------------------------------------------------------T-------T-----------------------------------------B-T----------------------------------------------------------f
----------------------------------------------------------------------T-T------T-----T--|-------|-T---------------------------------------|-|------T-------------------------------------------------T-f
------------------------M-T----M-TM-------MT-T-o-----T-----------T----|-|-TT-T-|-----|------T-T-|-|------T------------------------------M-|-|------|-T--T---------------------------------T---B-T-T-T|-f
--------TT----T-T-TT-TT-T-T----o?-T--------|-|-T-?-T-?-----------|--B-|-|-o--|-|-T--?|-T|-T-|-M-|-|B-M------------------------------ToT-M-X-X-M-TT-|-|-----------T------------T-T------T--|oT-T-?T-T-|-f
--T-?---|-T---T-|-|---B-|-B----B-----------|-|-T----T--------M---|-T--|------|-|-|---T-|X-|---|-X-|-o---------------------T---------|---T-------||-X-|-?---------|--|T-----------------|--|-T-|-|--|-|-f
-?--T-B-|--XX-|-|-|-----|-|--------T-------X-X------------T-B----X----X-X----X-X-|--T?-|T-|-X-X---X-T-T----T----M--------------B-XX-|---B-------|T-X-X-XX-X-M----|--|-XX-X-T---------B-|--X-E-|-X-X|-X-f
m-----E-X-T---X-X-XE-T--X-X-------E-E----T---------------------------T-E---------X--TT-X-T-------------E-E-----X--------------------X-X---------T-E-TX-X--T------X--X--------T-E-----XXXXX-TX-X-XX-----X
XXXXX-T-XX-T-XT-XXXX-T-X-T-XT-XXXXXXXXXXXX-T-XXXXXXXX-T-XXXXX-T-XX-T-XXXXXXXXXXXXXXXXXXXXXX-T-XX-T-XXXXXXXXXXXXXXX-T-XX-TT-XT-T-XXXXXXT-XX-T-XT-XXT-XXXXXX-T-XTXXXX-T-X-T-XXXX-T-XT-XXXXX-T-XXX-T-XX--XX
