---?E------E-E-----?-E---o---E----B--M------------B--X---X--E----------B------E--?----------------------X-EX---------------XM----Eo--B------E-----------------------------------------------------------
----------------E---M---B----M-------X--X-------X---BM----M--X----------------------E---?---Bo-----------------------------B-------------E-------B-X-------------------B----B---------E---XE------?-B---
-------E----X------------------X----E-----E---B-------X------X--B--------XBo---E-----B-----E----E-------E------------------------------M--EE?---E----------E-----B--E----X----EE---EE-----XE-E-oX?------
--B------o----BX--B--------E---E----E--------E------X-B-BE------------X-------Bo-----B---------------------X---X--B-B-EEB----------------X-------X-------B-----------E--------?---E--o--X----oX---------
-E----------BE---------E------o---------B-XB-X--?-------XX--M--XE---B---------EX-------B----o---o-----B--B-M-B-X--B------------------------?---X-E---?------M----M---B--E-----------XEX----X-----B------
-o--X----E-X-X---EX--------------E---o---E--------E--------B-----E-X----------?---EE-B-----------X--E--B----o-----E------BE-----E------B-E----X-B---X-BBB---E--X------E--B---M-------------M--B---------
----------XB-E-----X--?-?--E------XX-------------B------E-------B-----X--------X------M-XX-----M------E-o-------------B---?-----o-----------E--------o----B--?--------B--E-----X------------------------
-------X--B--?---o--X-B-X-----B----------X---------------XX-M----------o?-?-?--X-------X-----B------o--------------o--E---E---E-X-------E--E---------X-----X----o?--X?------X----B---B---X?--E---------v
-B----X---X----E-XB----M---o-X------Xoo--------------o---B-----------B-------ME---BM---X-------E-------------E---X---B--B-----B-M--?---?-MX--o----E---BX-----B----E----------Bo---------XB---------E-X-f
----BE----B-------E---E----------o-----?----------------E?--B--------------M-E--?o---------B-----E-----o-XX--X------E----o---BE-------------B-M------------------------E-X-------BoE-------BXM-----MEB-f
--M----B-----o-X---Bo?---X----E?oB-EEo--XM--B----E---B-B-E--o------------------BX-------X-----E--E----E----Mo-X----B-------------------X---?----------X------BoE--------X--?-------o-oE---BBo--------E-f
----X-?--o--E--BBo----------X--E---E---B--E----X-E--X-Eo-------------o---EB-E-----------------E------E--X-----B---------?-------o----Eo-----X--oE--XM?--------?--------X--B-B-----EM?-MX--oEE-------B-Ef
---E-?---------X---------X-EBo--EB---o-------E--------------------M-----?---XB--------X----------------------B--------E----M---E----?-----E----?-X?----o----?-X------------B----EXo----B--E-EE-X-E-BB--f
------------X----o?-----E----M-M--E-?E----B-----------EEEE--?--B?---X-E------o---E-----EM-----------BE-------X----X----??-----XEE----Eo-?-E----EX-o----------------B-------------B--------B------E-----f
mXoX-o--?----E---------E-----X--M--oB-E-X-------?--------E------------M----------?--T-?----E-----B-------|--X--X--------T-E?------B----E-------X--To--?X-----------BX---M---T---X--------|--EB-E-B-----X
XX-X-B-T--X-XB-XXo---XM-XXX?|--oXXXX-?--X----X-B-X-----XX---XX-E---XXT-XBXX-----XX-X-XXX---MX-B-X-XXXXX?-X-XX-XE------XX|-XX-?XXXX--X-X|X-XXX-BXXX-XEXXX-X-E-X-XX--X-XT-EX-XX-XX--XXXXXXXXXX--X|X--X---X
