---?E------E-E-----?-E---o---E--------o---?-------B--X---XM-E---------B------oE--M-----------B---o------X-oB---------------XM----Eo---------E--------------------------------B----M----EB------------X--
-----Xo---------E-------Bo----X-?----X--XM------X---BM-------X------------------?---E--E--o-oM-X-B---------X--B------------B-------------E-------B-X-------------------B----o--------------X--EEM-------
-------E----B----XM-B-------------X-------B---B-----B-X------X--B--------X-E--?E-----B-X--------E-------E-?-E--B-----------------------M-EEE----E--Xo------E-----B-XB---XX----EEE---------o-------B-----
--B------o----BX--B--------E---E----E----X--XE------X-B-BE--------------------?--------M--XB--?--------------o-?--B-B-EEB----------------X-------X-?-----B-----------E--------?---E----E-M-B-X------Eo--
-E--------E-BE-----E---E------Xo--------?-X--XE---------XX--M--XE--XB---B-----X------EEEE-------X-----B--B---BBX--B-----------------------??---X-E-o-o------M----M---B--E---------o--BX-?-M---o---------
-o-M-----EXXXX---E---------------E---o-E----------E-E-?----B--?--E-X---X------?M--EE-B-----E-B-XBX-ME--B----------E------BE---o-E------B------X-B--EX-EBB---E--X------E------o-------------------B------
---?------XB-E-----XMM--?--E---------------------B------E-------B-----X----X---X-----Mo--------M--------E-------------B---?-----------------E-------------B--?--------B--E-----X-Bo-------X--------X--X-
------EX--M-X----o----B-X-----B----------X---------------XX-Mo---------o?------------E----B------?-------o------------E-M-E---E-X-------EB-E---------X--B-------o?--X----?----?--------B-----E---??o--ov
-B--------XX---E-XB----M---o-E-----MXoo-----M--------o---B--------X----------X----X-----o----E---E-M------E--E---X---B--B-----B-M------?--X--o----E----X-----B----E-----------o-EBXX--X-X--E---E-B----Ef
----BX----------o-E--o-----------o--------?-------------E?--B------------MX--E--?----------X------X---X--X?--X------E----o---BE------------?B-M-----------B------------E-B---------E--Xoo---X------X-B-f
-------B-----o-X---------X----E?-M--E---X---B----E---BXB-o------------X---X-E--EX----------------E----E--?----X----B-------------------X---?----------X------BoE---------?-?-----X---o-----B?-------EE-f
--o-X-?---B-E--BBo----------X--E---E------E----X----X-Eo-------------o---B--E----------X-----BE---o--E--X---------------??------o----Eo---B-X---X--oME--------?--------X-------E----------o-E-B-------Ef
-M-E-?----------X--------E--BXo-EX---E---B--oE-------------E------------?oB-X-B------E-------o---?--?-----------------E----MX--E----?-----EE-----X-----o----?-X---------E?-B-B---?-o-E?---E-E-E--B--E--f
------------X----o?-----E---------E-?E------------XB--EEEE--BX-E?---X-E--o?-Xo------XX-E------------XE----XoBX----X----??-----XEE----Eo---E----EX-E----------------B----X---X-----E---M-----X---B---MB-f
m-oX----?X-|-E?------MBE-----X--B--oo-E---------?--------E---------------o---E------T-?----E-----B-?-----|--X-----------T-E?------B-----------MX-------X-------?---BX----E--?-----------?----o-E---B---X
XX-X-B-TX-X|XB-XXoX--XM--XX?|--oXXoX-?X-X-X--X-B-X-----XX---XX--X--oXT-XXX-X----XX-X-XXX--X-X-E-X-XXXXX?-X-X--XX------XX|-XX-?XXXX--X-X|--XXX-BXXX-XE-XX-X-E-X-XX--XEXT-EX-XXX---XMT----XXXX-X-XXE----XX
