--------------------------------------------------------------------------------------------------------------------------------------------------------------------------------------------------------
--------------------------------------------------------------------------------------------------------------------------------------------------------------------------------------------------------
--------------------------------------------------------------------------------------------------------------------------------------------------------------------------------------------------------
--------------------------------------------------------------------------------------------------------------------------------------------------------------------------------------------------------
--------------------------------------------------------------------------------------------------------------------------------------------------------------------------------------------------------
--------------------------------------------------------------------------------------------------------------------------------------------------------------------------------------------------------
--------------------------------------------------------------------------------------------------------------------------------------------------------------------------------------------------------
-------------------------------------------------------------------------------------------------------------------------------------------------------------------------------------------------------v
----------------------------------------------------------------------------------------T-------T-----------------------------------------B-T----------------------------------------------------------f
----------------------------------------------------------------------T-T-T----T-----T--|-------|-T---------------------------------------|-|--T---T-------------------------------------------------T-f
--------------------------T-o--M-TM-------MT-T-o-----T----------------|-|-|T-T-|---T-|--|-----T-|-|------T------------------------------M-|-|--|---|-T--T----------------------------T----T---B-T-T-T|-f
--------TT----T-T-TT--T-T-T----o?-T--------|-|-T-?-T-?----------------|-|-|--|-|-T-|?|-T|-T-|-|-|-|--M-------------------------------oT-M-X-X-MT-T-|-|------------------------T-T---------|-T-T-|T-T-|-f
--T-?---|-----T-|-|---B-|-|----B-----------|-|-T----T--------M-----T--|-|-|--|-|-|-|---|X-|-|-|-X-|-o---------------------T-------------T------|-|-X-|--------------|T--------------------|-T-|-|--|-|-f
-?--T-B-|--XX-|-|-|-----|-|----T---T---------X------------T-B--------TX-X-X--X-X-|-XT?-|T-|-X-X-o-X-T-T-----B------------------B---------------X-|-X-X-XX-X---------|-XX-X-T----XXXX-B----X-E-|-X-X|-X-f
m-----E-X-T---X-X-XE-T--X-X-------E-E----T---------------------------T-E------------TT-X-T-------------E-E---------------------------EX---------T-E-T--X--T---------X--------T-E------------X-X-XX-----X
XXXXX-T-XX-T-XT-XXXX-T-X-T-XT-XXXXXXXXXXXX-T-XXXXXXXX-T-XXXXX-T-XX-T-XXXXXXXXXXXXXXXXXXXXXX-T-XX-T-XXXXXXXXXXXXXXX-T-XX-TTX-T-T-XXXXXXXXXT-T-XT-XXT-XXXXXX-T-XXXXXX-T-X-T-XXXX-T-XT-XXXXX-T-XXX-T-XX---X
