--------------------------------------------------------------------------------------------------------------------------------------------------------------------------------------------------------
--------------------------------------------------------------------------------------------------------------------------------------------------------------------------------------------------------
--------------------------------------------------------------------------------------------------------------------------------------------------------------------------------------------------------
--------------------------------------------------------------------------------------------------------------------------------------------------------------------------------------------------------
--------------------------------------------------------------------------------------------------------------------------------------------------------------------------------------------------------
--------------------------------------------------------------------------------------------------------------------------------------------------------------------------------------------------------
--------------------------------------------------------------------------------------------------------------------------------------------------------------------------------------------------------
-------------------------------------------------------------------------------------------------------------------------------------------------------------------------------------------------------v
-------?--------------------------------B----------------------------------------------------------------------------------------------------------------------------------------T-------------------T-f
---------------------------------------------------------------------------T-----------------------------------------------------------------------------------------------------|-T-T-------------T-|-f
----T-M-T----------------------Mo-TT-T-----T-------------o---------------T-|-----T-T-T----T---T-----T---B-T-------------T---T---------T------------------------?------T-T--------|-|-|-----o-T---T-|-|-f
--T-|-|-|T-T-------T----------T-T-|--|-T-T-|----------------------------Bo-|-T-?-|-|-|----------------T---|-T---T---T---|-T---T-T--T--|-T---------------------------T-|-|-----T--X-|-|-T-----|-T-|-|-|-f
--|-|-|--T-|----------------------|--|-|-|-|T-M-T-|-T-B--------------------|-|-T-|-|-|-------------------M|-|-T---------|-|T--|----|-T|-|---------------------------|-|-|----------X-|-------|-|-|-|-X-f
--|-X-X-X--|----------------------X--X-|-|-X------|------------------------X-|-T-X-X-X--------M-------|-M-X-|-?-B-T-M---X-|-T-|-|--|--X-|X-T------------------------|-X-X------------X-------X-X-X-XBT-f
m-X-T-T----X--------------X---------T--X-X--------X----T---------------------X------------------------X-----X-T-----------X---X-X--X--X-X---------T-----T-----------X-X------------------------X-T-----X
X-------------------------------------------------T-----------------------------------------------------------------------------------X-X---------------X----------------------------------------------X
