-X-?E------E-E-------E---o---E--------------------B--X---X--E---X------B------E?-?----------------------E-EX-------------o--M----E-------oX-?---------?-----o----------------E--------------------------
-----------E----E-------B---X------B-X--X------EX---B--------X----------------------E-E--------------------------------o-----------------E-------B-X--------B--E-------E----B--------BE---XE------?-E---
--o----E-E--X----X------B-----------------B---B-------X------X--B--------XBo---E-----B-----E----E-------E--?--X---------------M------X-M--EE----E--Xo-------E-B--X-XE----X----EE---EE-----XE-E-MX?---?--
--B------o----BX--B--------E---E------?--X----------X-B-BE------------X----B--Bo--------------?------------X------o-B-E-B--E--M----------X-------X-------?-----------E--------?---E--o--X----oX---------
-E-----------E-----E---E---?--o---------B-X--X----------XX--M--XE---B---B------B-------B----o---o-----B--B-M-B-X--B--X---X----------------X----X-E---o------M-------oX--E-----------XEX----X-----B------
-o---------X-X---E-------?-------E---o-E--------B-E-------?B-----E-X----------?---EE-B-----------X--E--B-----B----E--E?--BE--o--E-------------X-B--EX-------E------------B---M---------M---M--B-o-------
----------XB-E------M------E---------X-----------B------E-----E-B-----X--------X------X-XM-----M------E-E------------E------------------B----B------------B----M---B--B--E-----X--------B--o-X----------
----------B------o--X-B-X-------X--------X---------------MX-M-----X-----?-?-?--X-------X-----B------o-----------------E-X-E--X?---------E-B----------X----------E---E-o-----X----B---B---X?--E---------v
-BM-?--X--X------XB----M---E-Xo-----Xoo--------------o---B-----------B-------XE---X----X-------E-------------E---X---B-------EB-o------------o----E----X---------------------Bo--------MXB---------E-X-f
----BX------------E---E---B---oo-o----E---?-------------E?--B-M------------M-E--?o---------B-----E-----oXXX--X-----?E-X--------B-----o-E---X--M--X--------------X-----EE-X-------BoE-------BX-------EB-f
-------B-----o-X------M---B---E?----Eo--X---o----E---B-B-E--------X------------BE-------X-----E--Eo--------Mo-X----------------------------?----------X------B--X??-----X--?-------o-oE---BBo--------E-f
----X-------?--BBo------------EEo--E------E----X----X-Eo-------------o---EB-E-----------------EM-----E--X--------------??-------o----Eo-----X------oM---E------o----------B-B-----EM?--X--oEE------MB-Ef
---E-X-----------------M--------EX---o---B---E--------------------M-----?---X-----------------------------------------E----X--------?--------B-?-X---XB----o?-X-E------M---B----EXo----B-BE-EE-X-E-BB--f
------------X--X-o?-----B-----X---E-?E----------------EEEE--?--B?---X-E------o---------EM-----------BE-------X----Xo---??-----XE---------------EX-EB------------------X-------E--B--------B------E-----f
m-oo-o--Eo---E---------E-----XE-ME-oB-E-X----------------E------------M-------------T-?----E-----B---o---|-EX-----M----TM--------o------E-M?T--X-------X--E--------XX---M---T---X--------|--EB-E-B-----X
XX-X-B-TX-X-?--XXoX--XM--XX?|XXXXXX--?X-X-X--X-B-X-----XX---XX-E---XXT-XBXXB----XX-X-XXX---MX-B-X-XXX-X?-X-XXXXX------oX|XXX-XXXXX--X-X-X--X-EBXXX-XEXXX-X-E-XXET-XX-XX-EX-XXXXX--XXXXXXXXX---X|X--X---X
