----E--------E-------E---o-----------ME-----------B------X--EE-------Bo-----X-E-------------------------X-o-----M--------o--o---EE--------X-?-----------------------X------E-------X--BE-------------X--
---X---?--------EB------B------------X----------X---B----?-B---?----XEM---------?---E--o--o-oX-X----------------M-------E-E--------E----XE----E--B-X-----------E-----?-B?-o-o---------o-X-XE--EEB-------
---E---E?--EX---------------------------------B-------X----?X---B--------X-o---E-----B-X-X------E--X----E----------B-o-----B---------X-M--Eo----E--Xo-o-----E-B--B-XE----X----EE---o------XE------B-----
--B--o---o-----X--B--B-----E--oE----E---------------X-B-BE----------o--------B?--------M------?-------------------o---E-B--E--o----------X---------------?-----------E-----?-E?---E----E?----X------E---
-BB----B-----E-----E---o----------------B-X--X----------Xo------E-o-----X-------------EBE-------X--?--o--B---B-X--B-------X------X--------X----X-E---o------M----M------E---------o---X-X--X--B---------
-o--------E--E---E---------X--E-XE---o------------E----E---B-X-X-E------------?M--EE-B-----E-B-XBX--E--B----------E------BE-----E-------------X-B--EX--o----E---------EBB----?---------X---M------------
---BE---------------B---?--E------X--------------B------E-------B-----X--------X---X--o--------M--------E-------------------?-----------M----B------------B----M---------X-----X-BX------------o----o?X-
-------ME-B------o-?X-B-X------B---------X----------------XB---B-------o?------------E-X--B------?-----o-o---?------E-E---E---E-E-------E-B--o-------X----------E?--X---?--o--?--------B--?--E-?-??-o-ov
-B---------------X-----M?--E-X------Xo-B-------------B---B--B---X------------X----X-----o----E-----M-B----E--E---X---B------B---o------------o----E----X--------E-E-----------o-E-----X-XB------------Ef
-EX--X--------X---E---E----------o-----?------------B---E?-----X---M--X-MM-M-E--?----------B-----B-----M-X?--X------E--------M-------o-E---X-MM--X------------X-X----?-E-X---------E--Xo---BX?o------B-f
-------B-----o-X----------B---E--B-EEo--X---B----E---B-B-E--BB-X------B---?-EX-EX----------------E----E-------X---------------M--------o---?----------X------B--X------B---?---------o----BB--------EE-f
--B?X-------E--BBo-------------E---E---B-------X----X-EoX-M-------?-------B-E----------X-----BE------E--X---------------?-------o----Eo-----X?------M---E------o---X?-BX------EE----------o-E---------Ef
-------oB------X---?------------EX---o--?---BE------B--B--------E-------?---XoB--------------o------------------------E----X------------B----B-?-X----------?--BE----------B-B-----E-E?EX-E-E-E-M---E--f
----?------------oo-o---E---------E-?E-----------------EEE--X---X---X-E------o------X--E------------BE----X--X----X----??o-----E-------M----o--Eo-E-E------------X-B--------------E---M---M---------MB-f
m-o----o---|-EE--------E-----------oB-E-X-----------oM----------T-------------------T-?----E-M---B-?-----|--X-?---------MM---------B----E---T--X-------X----Bo-----BX-----------E-------X|--EB-E-|-B--MX
XX-X-BETX-X-XB-XXoX--XM-XXX?-XXEXXXX--X-X---TX-?-X-----XX---X--E-|X-oT-XXXXB----XX-X-XXX--X-X-E-M-XXXXX?-X-XXXXX------XX|XXX-XXXXX--X-X-X--X--XXXX-XEXX--XME-XXET--XEXT-EE--XXoX-X-T-X--XXXX-X-XE-----XX
