-X-?E------E-E-------E---E---E--------------------B--X---X-oE----------B------E--?----------------------E-EX-------o-----o-XM----E---B------E--------------------MB-------------------------------------
----------------E-------B---X------B-X--X------EX---B--------X---X------------------E---?----E-----------------M-----------B-----------B-E---------X-----------E-------B----B---------E---XE--X---?-E---
--o----E-E--X----X------B-----------------?M--B-------X------X--B--------XBo--?E-----B-----E----E-------E-----X------------------------M--EE----E----------EE-B--B-XE----X----EE---EE-----XE-E-oX?------
--B------X----BX--B--------E---E------?--X----------X-B-BE------------X----B--Bo-----------E--?------------X------M-B-E-B---------------EX-------X-------B-BX--------E------------E--o?-X----oX---------
-E-----------E-----E---E---?--o---------B-X--X----------XX--M--XE---B---B----E-XX------B----o---o-----B--B-M-B-X--B---------------------M--?-M-X-E---?------M-------oX--E-----------XEX----X-----B------
-o-X----E--X-X---E-------B-------E---oXE----X-----E--------B-----E-X----------?---EE-B-----------X--M--B--------B-E--B---BE-----E------B-E-B--X-B---X--BB---E------------B---M-------------M--B---------
----o-----XB-E------M------E--------EX-----------B------E-------B-----X--------X------X-XM-----M------E-E-------------B---?-B---------------E--------o----B----M---B--B--E-----X------------------------
----------B------o--X-B-X-------X--------X---------------XX-M----------o?-?-?--X-------X-----B------o-----------------E-B-E-----X--o----E--E---------X----------E---E-o-----X----B---B---X?--E---------v
-BM-?--X--X------XB----M---E-Xo-----Xoo--------------o---B-----------B-------XE---X--B-X-------E-------------E---X---B--B-----B-M-M----?--X--o----E---BX--------E------------Bo---------XB---------E-X-f
----BX------------E---E---B------o--------?-------------E?--B--------------M-E--?o--XM-----B-----E-----o-XX--X-o---?E--------B--------------X-X----------M------X-----EE-X-------BoE-------BX------MEB-f
-------B-----o-X---M--M---B---E?----Eo--X--------E---B-B-E---------------------BE-------X-----E--E---------Mo-X----------------?-------Xo--?--?-------XX-----B--X?------X--?-------o--E---BBo--------E-f
----X-------?--BBo-------------E---E------E----X----X-Eo-------------o---EB-EE----------------EM-----E--X---------------?-------B----Eo-----X---E--XM?---------o----------B-B-----EM?--X--oEE-------B-Ef
---E-X-----------------M--------EX---o---B---E--------------------M-----?---X----------------------------------M------E----o---E----o-B---E----?-XB---M-----?-X-E----------B----EXo----B--E-EE-X-E-BB--f
------E-----X--X-o?-----X-----X---E-?EX---------------EEEE--?--B?---X-E------o---------EM-----------BE--E----X----X----??-----XEE-----o---E----E--o-------------------X----------B--------B------E-----f
m??o-o--Eo-?-E-X-------E-----XE-ME--B-E-X----------------E------------M---------M---T-?----E-----B-------|--XM---E------T--?------B------------X------?X-----oB-----X---M---T---X--------|--EB-E-B-----X
XX-X-B-TX-X-X--XXoX--XM--XX?|XXXXXXX-?X-X-E--X-B-X-----XX---XX-E---XXT-XBXXBM---XX-X-XXX---MX-B-X-XXX-X?-X-XXXXX------XX|-XB-?X-XX--X-X|X--XX-BXXX-X-XXX-X-E-XoET-XM-XX-EX-XX-XX--XXXXXXXXXX--X|X--X---X
