--------------------------------------------------------------------------------------------------------------------------------------------------------------------------------------------------------
--------------------------------------------------------------------------------------------------------------------------------------------------------------------------------------------------------
--------------------------------------------------------------------------------------------------------------------------------------------------------------------------------------------------------
--------------------------------------------------------------------------------------------------------------------------------------------------------------------------------------------------------
--------------------------------------------------------------------------------------------------------------------------------------------------------------------------------------------------------
--------------------------------------------------------------------------------------------------------------------------------------------------------------------------------------------------------
--------------------------------------------------------------------------------------------------------------------------------------------------------------------------------------------------------
-------------------------------------------------------------------------------------------------------------------------------------------------------------------------------------------------------v
----------------------------------------B------------------------------------------------------------------------------------------------------------------------------------------------------------T-f
---------------------------------------------------------------------------T--------------------------------?----------------------------------------------------------------------T-T-------------T-|-f
----T-M-T----------------------Mo-TT-T-----T-------------B---------------T-|-----T-T-T------------T-T-----T-------------T---------?---T------------------------?------T-T--------T-|-|-----------T-|-|-f
--T-|-|-|T-T-------T----------T-T-|--|-T-T-|---------------------T------Bo-|-o-?-|-|-|---------------?--o-|-T---T--oT---|-T---T-T--T--|-T---------------------------T-|-|-----T----|-|---------T-|-|-|-f
--|-|-|-|T-|----------------------|--|-|-|-|T-M-T-|-T-B-------------------B|-o-T-|-|-|----------------|--M|-|-T---------|-|T--|-|--|-T|-|---------------------------|-|-|--To------X-|-----M-T-|-|-|-X-f
--|-X-X-X--|----------------------X--X-|-|-X------|------------------------X---T---X-X------T---------|-M-T-|-?-B-T-----X-|-T-|-|--|--X-|X-T-o------------?-?-------|-X-X-B----------X-?-------|-X-X-T-f
m-X-T------X--------------X------------X-X--------T----T----------------------------------------------X-----X-T-----------X---X-X--X--X-X---------------------------X-X----T-T-----------------X-------X
X------------------------------------------------------------------------------------------------------------------------------------------------------------------------------------------------------X
