--------------------------------------------------------------------------------------------------------------------------------------------------------------------------------------------------------
--------------------------------------------------------------------------------------------------------------------------------------------------------------------------------------------------------
--------------------------------------------------------------------------------------------------------------------------------------------------------------------------------------------------------
--------------------------------------------------------------------------------------------------------------------------------------------------------------------------------------------------------
--------------------------------------------------------------------------------------------------------------------------------------------------------------------------------------------------------
--------------------------------------------------------------------------------------------------------------------------------------------------------------------------------------------------------
--------------------------------------------------------------------------------------------------------------------------------------------------------------------------------------------------------
-------------------------------------------------------------------------------------------------------------------------------------------------------------------------------------------------------v
-------?--------------------------------B----------------------------------------------------------------------------------------------------------------------------------------------------------T-T-f
---------------------------------------------------------------------------T---------------------------T----------------------------------?----------------------------------------T-T-------------|-|-f
----T-M-T----------------------Mo-TT-T-----T-------------o---------------T-|-----T-T-T----T-----------T---T-----------T-T-------------T---------------------------------T----------|-|-T-T-o-?---T-|-|-f
--T-|-|-|T-T-------T----------T-T-|--|-T-T-|----------------------------Bo-|-T-?-|-|-|---------------?-|--|-T---T---T-|-|-T---T-T-----|-T-----------------------T---T-T-|-------T--|-T---------T-|-X-|-f
--|-|-|-|T-|----------------------|--|-|-|-|T-M-T-|-T-B--------------------|-|-T-|-|-|-----------------|-T|-|---------|-|-|T--|-|----T|-|---------------------------|-|-|----------X-|-----T-T-|-|-|-X-f
--|-X-X-X--|----------------------X--X-|-|-X------|------------------------X-|---X-X-X-----------------X----|---B-T---X-X-|-T-|-|-----X-|X-T--------------?-?-------|-B-X------------X---------|-X-X-T-f
m-X-T-T----X--------------X------------X-X--------X----T---------------------X------------------------------X-TT----------X---X-X-----X-X---------------------XXX-X-X-X----T-T-------T---------X-------X
X--------------------------------------X----------T-----------------------------------------------------------------------X------------------------------------X--X-X-T--------------------------------X
