--??E-?----E-E-----?-E---o---E--------o---?-------B--Xo--X--E----------BX-----EX-?-------------M----?---B-EX-------------o--M----E---B------E----X------------B----------------------X---------------X--
--------------M-E-------Bo----X------X--XM------X---BM-------X----------------?-----E---?--oB-X-------------------------------------o----E-M-----B-X-------------------B--X-----------E---XE------?-E---
-------E----B----X--B--------------------EB---B-----B-X------X--B--------XBo---E-----B-----E----E-------E-----X-----------------------XM--EE----E----------E-----B-XE----X----EE---EE-----XE-E-oX?------
--B------o----BX--B--------E---E----E----X--XE------X-B-BE------------X----B--BX--------------?------------X------E-?-E-B--E-------------X-------X-------B----------?E-----?--?---E--o--X----oX------X--
-E--------E-BE---------E------oo--------?-X--XE---------XX--M--XE---B---B------X------------o---o-----B--B-M-B-X--B--X---X-----------------?---X-E---?------M----M---B--E-----------XEX----X-----B------
-o------XEXXXX---E---------------E---o-E----------E-E------B-----E-X----------?---EE-B-B---------X--E--B-------?B-E--E??-BE---X-E-------------X-B--E---BB---E--X-----B?-BE--Xo-------------M--B---------
----------XB-E-----XMM--?--E---------------------B------E-------B-----X--------X------X-X------M------E-E--M---X----?E----------------------E--------o----B--?--------B--E-----X--------B-------------X-
------EX--M-XM---o--X-B-X--E--B----------X------o--------XX-M----------o?-?-?---------BX-----B------o-----------------E---E---E-X------XE--E---------X----------o?--?---Eo-o-----B---B---X?--E--------ov
-B--------XX---E-XB----M---o-E------Xoo-----M--------o--BB-------------------XE-X-Xo---X-------E-------------E---X------------B-M---------X--o-o--E---BX----------E---------------------XB------------Ef
----BX----------o-E--o-----------o--------?-------------E?B-B--------------M-E--?o---------B-----E-----o-XX--X-o---?E-X-------E-------------B-M---?--------------------E---------BoE-------BX-------EX-f
-------B-----o-X---------X----E?-B--E---X--------E---BXB-o---------------------BX-------------E-MEX---E----Mo-X-----------------------?o---?----------X------BoE-----------?-------o-oE---BBo--------E-f
----X-?-----E--BBo---?------X--E-X-E------E-B--X----X-Eo--------X----o---EB-E--B-----------E--E------E--o---------------M----E--o----Eo-----X---E--XM?--------?--------X---B------EM?--X--oEE------MB-Ef
-M-E-?---------X---------E--BX--EX---o---B---E--------------------------?---X-----E------E---------------------M------E----X---E----?-o-B-E----?-X-------o--?-X-----------?B----EBo----B--E-EE-X-E-BB--f
------------X-E--o?X----E--------BE-?E-------------B--EEEE--?--B?---X-E------o---------EM-----------BE-------X--E-------?-----XEE----E----E--?-EX-o----------------B---------M---B--------B------E---B-f
m-oX-o--?X-|-E---------E-----X-----oo-E---------?--------E------------M-------------T-?----E-----B-------|--X----E-----TM-X-------B------------X------?X-E---------BX-o---------X--------|--EB-E-B----EX
XX-X-B-TX-X-XB-XXoX--XM-XXX?|--oXXoX-?X-X-X--X-B-X-----XX---XX-E--BXEX-XBXXB----XX-X-XXX---BX-B-X-XXXXB?-X-XXXX?-----?TX|MXX-?XXXX--X-?-T-XXX-BXXX-XBXX--X-E-XEXX-XXEXT-E---XXXX--XXXXXXXXXX--X|X--X--XX
