--------------------------------------------------------------------------------------------------------------------------------------------------------------------------------------------------------
--------------------------------------------------------------------------------------------------------------------------------------------------------------------------------------------------------
--------------------------------------------------------------------------------------------------------------------------------------------------------------------------------------------------------
--------------------------------------------------------------------------------------------------------------------------------------------------------------------------------------------------------
--------------------------------------------------------------------------------------------------------------------------------------------------------------------------------------------------------
--------------------------------------------------------------------------------------------------------------------------------------------------------------------------------------------------------
--------------------------------------------------------------------------------------------------------------------------------------------------------------------------------------------------------
------------------------------------------------------------------------------------------------------------------------------------------------------------------------------------------T------------v
----------------------------------------------------------------------------------------T-------T----------------T------------------------B-T---------------------------------------------|------------f
----------------------------------------------------------------------T-T-T----T-----T--|-------|-T--------------|------------------------|-|--T---T--------------------------------------|----------T-f
--------------------------T----M-TM-------MT-T-o-----T----------------|-|-|T-T-|---T-|--|-B---T-|-|------T-------|----------------------M-|-|--|---|-T--T---------------------------------|---B-T-T--|-f
--------TT----T-T-TT--T-T-T----o?-T--------|-|-T-?-T-?--------------B-|-|-|--|-|-T-|?|-T|-T-|-|-|-|--M-----------X-------------------oT-M-X-X-M|-T-|-|------------------------T-T---------|-T-T--T-T-|-f
--T-?---|-----T-|-|---B-|-|----B-----------|-|-T----T--------T-----T--|-|-X--|-|-|-|---|X-|-|-|-X-|-o---------------------T-------------T------|-|-X-|-?------------|T------------T-------X-T-|-|--|-|-f
-?--T-B-|--XX-|-|-|-----|-|----T---T-------X-X------------T-B---------X-X----X-X-|-XT?-|T-|-X-X-o-X-T-T-----B------------------B---------------X-|-X-X-XX-X---------|-XX-X-T-T-------B----X-|-|-X-X|-X-f
m-----E-X-T---X-X-XE-T--X-X-------E-E----T---------------------------T-E---------X--TT-X-T-------------E-E---------------------------EX---------T-E-TX-X--T---------X--------T-E------------X-X-XX---T-X
XXXXX-T-XX-T-XT-XXTX-T-X-T-XT-XXXXXXXXXXXX-T-XXXXXXXX-T-XXXXX-T-XX-T-XXXXXXXXXXXXTXXXXXXXXX-T-XX-T-XXXXXXXXXXXXXXX-T-XX-TT-XT-T-XXXXXXXXXT-T-XT-XXT-XXXXXX-T-XXXXXX-T-X-T-XXXX-T-XT-XXXXX-T-XXX-T-X---XX
