--------------------------------------------------------------------------------------------------------------------------------------------------------------------------------------------------------
--------------------------------------------------------------------------------------------------------------------------------------------------------------------------------------------------------
--------------------------------------------------------------------------------------------------------------------------------------------------------------------------------------------------------
--------------------------------------------------------------------------------------------------------------------------------------------------------------------------------------------------------
--------------------------------------------------------------------------------------------------------------------------------------------------------------------------------------------------------
--------------------------------------------------------------------------------------------------------------------------------------------------------------------------------------------------------
--------------------------------------------------------------------------------------------------------------------------------------------------------------------------------------------------------
-------------------------------------------------------------------------------------------------------------------------------------------------------------------------------------------------------v
----------------------------------------------------------------------------------------T-------T-----------------------------------------B-T----------------------------------------------------------f
----------------------------------------------------------------------T-T-T----T-----T--|-------|-T---------------------------------------|-|------T-------------------------------------------------T-f
-o---------------T-------------M-TM-------MT-T-oT----T----------------|-|-|T-T-|-----|--|-----T-|-|------T------------------------------M-|-|------|-T--T---------------------------------T---B-T-T----f
--------TT----T-T--T--T-T-T----o?-T------T-|-|-T|?-T-?--------------B-|-|-|--|-|-T--?|-T|-T-|-|-|-|--M------------------------------ToT-M-X-X-M-TT-|-|-----------T------------T-T---------|-T-T--T-T-|-f
----?---|-T---T-|-----B-|-|--------------|-|-|-T|---T--------M-----T--|-|-X--|-|-|-----|X-|-|-|-X-|-o---------------------T---------|---T--o----||-X-|-?---------|--|T--------------------|-T-|-|--|-|-f
----T-B-|--XX-|-|-------|-|--------T-----|-X-X--X---------T-B-T-------X-X----X-X-|--T?-|T-|-X-X---X-T-T---------M--------------B-XX-|---B-------|T-X-X-XX-X-M----|--|-XX-X-T--T------B----X-|-|-X-X|-X-f
m-----E-XE----X-X--E-T--X-X-T-----E-E----X---------------------------T-E---------X--TT-X-T-------------E-E-----X--------------------X-X---------T-E-TX-X--T------X--X--------T-E------------X-X-XX-----X
XXXXX-T-XX-T-XT-XXXX-T-X-T-XT-XXXXXXXXXXXX-T-XXXXXXXX-T-XXXXX-T-XX-T-XXXXXXXXXXXXXXXXXXTXXX-T-XX-T-XXXXXXXXXXXXXXX-T-XX-TT-XT-T-XXXXXXT-XX-T-XT-XXT-XXXXXX-T-XTXXXX-T-X-T-XXXX-T-XT-XXXXX-T-XXX-T-X---XX
