--------------------------------------------------------------------------------------------------------------------------------------------------------------------------------------------------------
--------------------------------------------------------------------------------------------------------------------------------------------------------------------------------------------------------
--------------------------------------------------------------------------------------------------------------------------------------------------------------------------------------------------------
--------------------------------------------------------------------------------------------------------------------------------------------------------------------------------------------------------
--------------------------------------------------------------------------------------------------------------------------------------------------------------------------------------------------------
--------------------------------------------------------------------------------------------------------------------------------------------------------------------------------------------------------
--------------------------------------------------------------------------------------------------------------------------------------------------------------------------------------------------------
-------------------------------------------------------------------------------------------------------------------------------------------------------------------------------------------------------v
----------------------------------------B------------------------------------------------------------------------------------------------------------------------------------------------------------T-f
---------------------------------------------------------------------------T-------------------------------------------------------------------------------------------------------T-T-------------T-|-f
----T-M-T----------------------M--TT-T-----T-------------o---------------T-|-----T-T-T----T---------T-----T-------------T---T---------T------------------------?------T-T--------T-|-|-----------T-|-|-f
--T-|-|-|T-T-------T----------T-T-|--|-T-T-|----------------------------Bo-|-T-?-|-|-|------------o--?T---|-T---T-------|-T---T-T--T--|-T----------T----------------T-|-|-----T-T--|-|---------T-|-|-|-f
--|-|-|-|T-|----------------------|--|-|-|-|T-M-T-|-T-B--------------------|-|-T-|-|-|--------------T-|--M|-|-T---------|-|T--|-|--|-T|-|---------------------------|-|-|--To------X-|-----M-T-|-|-|-X-f
--|-X-X-X--|----------------------X--X-|-|-X------|-----XXXX---------------X-|-T-X-X-X----------------|-M-X-|-?-B-T-----X-|-T-|-|-----X-|X-T--------------?-?------T|-X-X------------X-?-------|-X-X-T-f
m-X-T-T----X--------------X------------X-X--------X----T---------------------X------------------------X-----X-T-----------X---X----X--X-X---------------------------X-X----T-T-----------------X-------X
X-------------------------------------------------------------------------------------------------------------------------------------X-X--------------------------------------------------------------X
