-XE?E------E-E-----?-E---o---E----B--M------------B--X---X--E---------?BX----EE--?---------B---M--------E-EX-------------o-XM----E---B------E---------------o-------------------------E-------M---------
----------------E-------B----M-------X--X-------X---B--------X----------------------E---?---B-X----------------M-----------B-------------E-------B-X--------B--E-------E----B---------E---XE------?-E---
-------E----X-----------------------E-----E--EB-------X------X--B--------XBo---------B-----E----E-------E-?---X------------------------M--EE----E-----------E-B--X-XE----X----EE---EE-----XE-E-MX?------
--B------o-M--BX--B--------E---E----E-----------------E-BE------------X----B--BX-B------------?----------o-X------M-B-E-B--o------------EX-------X-------?---------E-E--------?---E--o--X----oX---------
-E----------BE------o--E------o---------B-XB-X----o-M---XX--M--XE---B---B------X-------B----o-M-o-----B--B-M-B-X----X----------------------?-M-X-E---?------M-------oX--E-----X-----XEX----X-----B------
-o-------E-X-X--BEX--------------E---o---E--------EX----o--B-----E-B--o-------?---EE-B-B--?------X--E--B--------B-E--B---BE-----E---E--B-E-B--X-B---X--BB---E------------B---M-------------M--?---------
---E------?B-E-----X--?----E------XX------o-----B?------E-------B-----X--------X------X-X------M------E-E-------------B---?-B---------------E--o-----o----B--X-M---B--B--E-----X--------B--o----------X-
-------X--B--?---o--X-B-X-----B----------X------------M--XX-Mo---------o?-?-?--X------BX-----B------o-----------------E---E-----X--o----E--E---------X-------M--E---E-o-----X----B---B---X?--E-------Bov
-B----X---X----E-XB----M---o-?--M---Xoo-----?--------B---B-------o---B-------XEM-------X-------E-------------E---X---B--B-----B-M-M----?--X--o----E---BX---------------------Bo---------XB---------E-XEf
----BX----B-------E---E----------o-----?----------------E---B--------------M-EB-?o---------B-----E-----o-XX--X-o---?E--------B--------------B-X-----------------X-----EE-X-------BoE-------BX-------EB-f
-------B-----o-X---Bo----X----E?oB-EEo--X---BE--XE---BXB-o---------------------BX-------------E--E---------Mo-X----------------?-------Xo--?--?-------X------B--X?------X--?-------o-oE-X-BBo--------E-f
----X-?--o--E--BBo----------X--E---E---B--E---------X-E---------X----o----B-E---------------E-E----?-E--X---------X-----?-------o-?--Eo-----X---E--XM?---------o----------B-B-----EM?--X--oEE------MB-Ef
---E-?---------X---------X-EB---EB---o-------EX---E--------------------E?---X-----E-B----E---------------------M------E----M---E----o-B---E----?-XB---M-----?-X-E------M---B----EXo----B--E-EE-X-E-BB--f
------------X----o?-----E----M-M--E-?E----B--M--------oMEE--?--B?---X-E------o---------EM--------B--BE--E----X--E-X----??-----XEE-----o---E----EX-o-------------------X----------X-------MB------E-----f
m-oX-o--?--o-E---------E---X-X--M--oB-E-X--EBo-M-B------EEM-----------M-------------T-?---EE?----B-------|--X----E--|---T--?------B------------X------?X--E--o-----XX---M---T---X--------B--EB-E-B----EX
X--X-B-T--X-XB-XXoX--XM-XXX?|--oXXXX-?--X---XX-X-XX----XX---XX-E--BXEX-XBXXB----XX-X-XXX---BX-B-X-XXX-E?-X-XXEXX------XX|-XX-?X-XX--X-X|X--XX-BXXX-X-XXX-X-E-XXET-EX-XX-EX-XXXXX--XXXXXXXXX---X|X-MX--XX
