-X-XE------E-E-------E---E---E--------------------B--X---X-oE----------BX----EE--?---------B---M--------E-EX-------------o-XM----E---B------E---------------o-------------------------E-------M---------
----------------E-------B---X------B----X------EX---B--------X----------------------E---?---B-X----------------M-----------B-------------E-------B-X--------B--E-------E----B---------E---XE------?-E---
--o----E-E-------XE-----B-----------------BM--B---X---X------X--B--------XXo---------B-----E----E-------E-?---X------------------------M--EE----E-----------E-B--X-XE----X----EE---EE-----XE-EEMX?------
--B-?---Eo----BX--B--------E---E------?--X----B-----X-B-BE------------X----B--BX-B------------?----------o-X------M-B-E-B--o------------EX-------X-------?---------E-E--------?---E--o--X----oX---------
-E-----------E-----E---E---?--o------B--B-X--X----------XX--M--XE---B---B------X-------B----o-M-o-----B--B-M-B-X----X----------------------B-M-X-E---?------M-------oX--E-----X-----XEX----X-----B------
-o-?----E--X-X---E---?---B-------E---o-E----X-----E-------EB-----E-X----------?---EE-B-B--?------X--E--B--------B-E--B---BE-----E---E--B-E-B--X-B---X--BB---E------------B---M-------------M--?---------
----------XB-E------M------E-------MEX-----------B------EX------B-----X--------X------X-X------M------E-E-------------B---?-B---------------E--o-----o----B--X-M---B--B--E-----X--------B--o----------X-
----------B------o--X-B-X-------B---E----X---------------XX-M----------o?-?-?--X------BX-----B------o-----------------E---E-----X--o----E--E---------X-------M--E---E-------X----B---B---X?--E-------Bov
-BM-?--X--X------XB----M---E-Xo-----Xoo--------------o---B-----------B-------XEM-------X-------E-------------E---X---B--B-----B-M-M----?--X--o----E---BX----------------------o---------XB---------E-XEf
----BX------------E---E---B------o----------------------E?--B--------------M-EB-?o---------B-----E---o-o-XX--X-o---?E--------B--------------B-X-----------------X-----EE-X------?BoE-------BX-------EB-f
-------B-----o-X------M---B---E?----Eo--X-------ME---B-B-E---------------------BX-------------E--E---------Mo-X----------------?-------Xo--?--?-------X------B--X?------X--?-------o-oE-X-BBo--------E-f
----X-------?--BBo---M---------Eo--E------E----X----X-Eo-------------o----B-E---------------E-E----?-E--X---------X-----?-------o-?--Eo-----X---E--XM?---------o----------B-B-----EM?--X--oEE------MB-Ef
---E-X----------M------M--------EX---o---B---E--------------------M-----?---X-----E-B----E---------------------M------E----M---E----o-B---E----?-XB---M-----?-X-E------M---B----EXo----B--E-EE-X-E-BBX-f
------------X--X--?-----B-----X---E-?E----M-----------EEEE--?--B?---X-E------o---------EM--------B--BE--E----X--E-X----??-----XEE-----o---E----EX-o-------------------X----------X-------MB------E-----f
m??o-o--Eo-?-E---------E---?-XE-ME-oB-E-X----------------E------------M-------------T-?---EE?----B-------|-TX----E--|---T--?------B------------X------?X--E--o-----XX---M---T---X--------B--EB-E-B----EX
XX-X-B-TXXX-X--X-oX--XM--XX?|XXXXXXX-?X-X-X--X-B-X-----XX---XX-E---XXT-XBXXB----XX-X-XXX---BX-B-X-XXX-E?-X-XXEXX------XX|-XX-?X-XX--X-X|X--XX-BXXX-X-XXX-X-E-XXET-EX-XX-EX-XXXXX--XXXXXXXXX---X|X-MX--XX
