--------------------------------------------------------------------------------------------------------------------------------------------------------------------------------------------------------
--------------------------------------------------------------------------------------------------------------------------------------------------------------------------------------------------------
--------------------------------------------------------------------------------------------------------------------------------------------------------------------------------------------------------
--------------------------------------------------------------------------------------------------------------------------------------------------------------------------------------------------------
--------------------------------------------------------------------------------------------------------------------------------------------------------------------------------------------------------
--------------------------------------------------------------------------------------------------------------------------------------------------------------------------------------------------------
--------------------------------------------------------------------------------------------------------------------------------------------------------------------------------------------------------
-------------------------------------------------------------------------------------------------------------------------------------------------------------------------------------------------------v
----------------------------------------B----------------------------------------------------------------------------------------------------------------------------------------T---?---------------T-f
---------------------------------------------------------------------T-----T---------------------------------------------------------------T-------------------------------------|-T-T-------------T-|-f
----T-M-T----------------------M--TT-T-----T-------------o-----------|---o-|---M-T-T-T--------T-----T-----T-----------T-T---T---------T----|-------------------?------T-T--------|-|-|------o----T-|-|-f
--T-|-|-|T-T-------T----------T-T-|--|-T-T-|-------------------------|--Bo-|-o-?-|-|-|----------------T---|-T---T---T-|-|-T---T-T--T--|-T--|------------------------T-|-|-----T--X-|-|---------T-|-|-|-f
--|-|-|-|T-|----------------------|--|-|-|-|T-M-T-|-T-B--------------X--B--|-o-T-|-|-|----------------|--M|-|-T-------|-|-|T--|----|-T|-|--X------------------------|-|-|----------X-|T----T-T-|-|-|-X-f
--|-X-X-X--|----------------------X--X-|-|-X------|------------------------X---T-X-X-X------T-M-------|-M-X-|-?-B-T-M-X-X-|-T-|-|--|--X-|X-T------------------------|-X-X------------X-?-------B-X-X-T-f
m-X-T-T----X--------------X------------X-X--------X----T----------------------------------------------X-----X-T-----------X---X-X--X--X-X---------------T-----------X-X----T-------------------X-------X
X--------------------------------------X----------------------------------------------------------------------------------------X--X--X-X--------------------------------------------------------------X
