----E--------E---EB--E---o-----------------X------B--X---X--E----X-----BX-----E--?---------------------------------------o-Xo----EB------oX-?---------------o-------------------------------------------
--?M------------E-------XX-----M----EX--X----X-------------B-X----------------------E---?---B------------------------BX------------------E-------B-X--------B--E-------E----B---------E---XE------?-E---
-X-oE--E---BX-E--X---------------------?-----oB-------X------X--B--------XBo--XE----?B--B--E----E----E----------o--------------------X-M--EE----E--Xo-------E-B--X-XE----X----EE---EE-----MEME-MX?------
-XE--o---o----B------------E---E----o-X-------------X-B-B-------------E----B--Bo-E---X--------?-----M-------------o-B-E-BB---------------X-------X-------?-----------E--------?M--E--o--X----oX---------
-------------E--o--E---E------o-E---o---BB-B------------XX------E--BB----------X-------B----o---o----E-Bo-MB-B-X--B-----------------------X----X-E---o------M-------oX--E-----------XEX----X-----B------
-oE?------B--X---E------MM-------E---X------------E--------B-----E-X----------?---EE-B-----------X-------M---X----E------BE----BE---------E---X-B--Eo-------E------------B---M-------------M--B---------
-------------E------M---?--E--XE----?------------B------E-------B-----X--B-----X----?-X--------M-B-o--B---------------B---?--?-----E----B----B------------B----M---B--B--E-----X--------B--o------------
-------M-XB--X---o--X-B-o-?------------------------------XX-MX---------o?-?-?--X------BX-----B------?-E---o-----------E---E---E-X-------E-B----------X----------E---E-o-----X----B---B---X?E-E---------v
-B----------------B----M---E-X------Xo------?--------o---------------B----B--XE---X----X-------E-----Eo------E---X---B--B-----?-M------------o----E----X---------------------Bo---------XB---------E-X-f
-----B----------??E---E------X---E---X---E-----X--------E?--B--------------M-E--?o---------B-----E--------?--XB-----E--------B-------o-E---X--M--X--------------X-----EE-X-------BoE------?BX-------EB-f
-------B-----o-X------M---B---E------o--X---BX---E---B-BBE---------------------BX-------------E--E-----o------X------------------------o---E----------X------B--X?------X--?-------o-oE---BBo--------E-f
------------E--BBo-------------E---E--E---E----B----X-Eo-------------o---EB-E-----------------E------E---B--M-M---------?-------o-?--Eo-----X------oM---E------o----------B-B-----EM?--X--oEE------MB-Ef
--o--X---------------B---X------E-B--oXo-X---E--?----------B------------?---XB----------------------------------------E-------XE----?---M----B-?-X----------?-X-E------M---B----EXo----B--E-EE-X-E-BB--f
----------------------Xo----------E-?E----------------EEEE--?--B?---X-E--M---o---------EM----M------B---B--oBX----X----??-----XEE-?-----------MEX-EB------------------X----------B--------B------E-----f
m-o--?----E--E-----------------T--?oB-X-X---B---o--------E------------M-------B--M--T-?----E-----B---E---|--X-----X-----T--?------B-----E--?T--X-------X--E--o-----XX---M---T---X--------|--EB-E-B-----X
XX-X-B-T?-X-X--XXoX--XX-XXX-|XXXXX-X-?X-XT--XX-o-X-----XX----X?E--|-ET-XBXXB----XX-X--XX---XX-B--EXXXXX--XME---E--B---XX|-XB-?XXXX--X-X-X--X-EXXXX-XEXXX-X-E-XXET-XX-XT-EX-XXXXX--XXXXXXXXX---X|X--X---X
