--------------------------------------------------------------------------------------------------------------------------------------------------------------------------------------------------------
--------------------------------------------------------------------------------------------------------------------------------------------------------------------------------------------------------
--------------------------------------------------------------------------------------------------------------------------------------------------------------------------------------------------------
--------------------------------------------------------------------------------------------------------------------------------------------------------------------------------------------------------
--------------------------------------------------------------------------------------------------------------------------------------------------------------------------------------------------------
--------------------------------------------------------------------------------------------------------------------------------------------------------------------------------------------------------
--------------------------------------------------------------------------------------------------------------------------------------------------------------------------------------------------------
-------------------------------------------------------------------------------------------------------------------------------------------------------------------------------------------------------v
-------?--------------------------------B----------------------------------------------------------------T------------------------------------------------------------------------------M------------T-f
---------------------------------------------------------------------------T--------------------------?T-|---------------------o----------------------T----------------------------T-T-------------T-|-f
----T-M-T----------------------Mo-TT-T-----T-------------o---------------T-|-----T-T-T----T----------T-|-|T-----------T-T---T---------T---------------|-----------------T-?------T-|-|-T---o-----T-|-|-f
--T-|-|-|T-T-------T----------T-T-|--|-T-T-|----------------------------Bo-|-T-?-|-|-|---------------|-|-X|-T---T---T-|-|-T---T-T--T--|-T-------o-----|-------------T-T-|-------T--|-T------B--T-|---|-f
--|-|-|-|T-|----------------------|--|-|-|-|T-M-T-|-T-B--------------------|-|-T-|-|-|---------------|-|-T|-|---------|-|-|T--|-|--|-T|-|--------T----X-------------|-|-|---o------X-|-------T-|-|-|-X-f
--|-X-X-X--|----------------------X--X-|-|-X------|------------------------X-|-T-X-X-X---------------X-X--X-|---B-T---X-X-|-T-|-|--|--X-|X-T-o------------?-?-------|-|-X------------X---------X-X-X-T-f
m-X-T-T----X--------------X------------X-X--------X----T-------------T-------X------------------------------X-TT----------X---X-X--X--X-X---------------------------X-X----T-T-------T---------X-T-----X
X-------------------------------------------------------------------------------------------------------------------------------------X----------------------------------------------------------------X
