--------------------------------------------------------------------------------------------------------------------------------------------------------------------------------------------------------
--------------------------------------------------------------------------------------------------------------------------------------------------------------------------------------------------------
--------------------------------------------------------------------------------------------------------------------------------------------------------------------------------------------------------
--------------------------------------------------------------------------------------------------------------------------------------------------------------------------------------------------------
--------------------------------------------------------------------------------------------------------------------------------------------------------------------------------------------------------
--------------------------------------------------------------------------------------------------------------------------------------------------------------------------------------------------------
--------------------------------------------------------------------------------------------------------------------------------------------------------------------------------------------------------
-------------------------------------------------------------------------------------------------------------------------------------------------------------------------------------------------------v
----------------------------------------B------------------------------------------------------------------------------------------------------------------------------------------------------------T-f
---------------------------------------------------------------------------T--------------------------?T---------------------------------------------------------------------------T-T---T---------T-|-f
----T-M-T----------------------M--TT-T-----T-------------o---------------T-|-----T-T-T----T----------T-|--T-----------T-T-------------T---------------------------------T----------|-|-T-|---T---T-T-|-f
--T-|-|-|T-T-------T----------T-T-|--|-T-T-|---------------------T------Bo-|-o-?-B-|-|---------------|-|--|-T---T---T-|-|-T---T-T-----|-T-----------------------T---T-T-|-------T--|-T---|-----T-|-|-|-f
--|-|-|-|T-|----------------------|--|-|-|-|T-M-T-|-T-B-------------------B|-o-T-|-|-|-?-------------|-|-T|-|---------|-|-|T--|-|----T|-|---------------------------|-|-|----------X-|---|---T-|-|-|-X-f
--|-X-X-X--|----------------------X--X-|-|-X------|------------------------X---T-X-X-X---------------X-X----|---B-T---X-X-|-T-|-|-----X-|X-T--------------?-?-------|-B-X------------X---X---T-X-X-X-T-f
m-X-T-T----X--------------X------------X-X--------X----T----------------------------------------------------X-TT----------X---X-X-----X-X---------------------XXX-X-X-X----T-T-------T---------X-------X
X--------------------------------------X----------------------------------------------------------------------------------X------------------------------------X--X-X-X--------------------------------X
