--------------------------------------------------------------------------------------------------------------------------------------------------------------------------------------------------------
--------------------------------------------------------------------------------------------------------------------------------------------------------------------------------------------------------
--------------------------------------------------------------------------------------------------------------------------------------------------------------------------------------------------------
--------------------------------------------------------------------------------------------------------------------------------------------------------------------------------------------------------
--------------------------------------------------------------------------------------------------------------------------------------------------------------------------------------------------------
--------------------------------------------------------------------------------------------------------------------------------------------------------------------------------------------------------
--------------------------------------------------------------------------------------------------------------------------------------------------------------------------------------------------------
-------------------------------------------------------------------------------------------------------------------------------------------------------------------------------------------------------v
----------------------------------------------------------------------------------------T-------T-----------------------------------------B-T---------------M------------------------------------------f
----------------------------------------------------------------------T-T-T----T-----T--|-------|-T---------------------------------------|-|--T---T-------------------------------------------------T-f
------T------------------------M-TM-------MT-T-o-----T----------------|-|-|T-T-|---T-|--|-----T-|-|------T------------------------------M-|-|------|-T--T---------------------------------T---B-T-T-T|-f
------|-TT----T-T--T--T-T-T----o?-T--------|-|-T-?-T-?--------------B-|-|-|--|-|-T-|?|-T|-T-|-|-|-|--M-------------------------------oT-M-X-X-M|-T-|-|------------------------T-T---------|-T-T-|T-T-|-f
--T-?-|-|-----T-|-----B-|-|----B-----------|-|-T----T--------M-----T--|-|-X--|-|-|-|---|X-|-|-|-X-|-o---------------------T------T-------------|-|-X-|-?------------|T--------------------|-|-|-|T-|-|-f
----T-X-|--X--|-|-------|-|--------T-------X-X------------T-B---------X-X----X-X-|-XT?-|T-|-X-X-o-X-T-T-----B------------------B---------------X-|-X-X-XX-X---------|-XX-X-T-T-------B----X-|-|-X-X|-X-f
m-----E-XE------X--E-T--X-X-------E-E----T---------------------------T-E---------X--TT-X-T-------------E-E---------------------------EX---------T-E-TX-X--T---------X--------T-E------------X-X-XX---T-X
XXXXX-T-XX-T-XT-XXXX-T-X-T-XT-XXXXXXXXXXXX-T-XXXXXXXX-T-XXXXX-T-XX-T-XXXXXXXXXXXXTXXXXXXXXX-T-XX-T-XXXXXXXXXXXXXXX-T-XX-TT-XT-T-XXXXXXXXXX-T-XT-XXT-XXXXXX-T-XXXXXX-T-X-T-XXXX-T-XT-XXXXX-T-XXX-T-XX--XX
